nu#a	true
lente#n	true	lentes	feminine plural
plural#a	true
libre#a	true
van#n	true	vans	masculine plural
van#v	true
van#a	true
te#prn	true
can#n	true	cans	masculine plural
o#prn	true
numeral#n	false	numerais	masculine plural
seme#n	true	semes	feminine plural
man#n	true	mans	feminine plural
os#prn	true
peso#n	true	pesos	masculine plural
estar#v	true
libero#v	true
ten#v	true
singular#a	true
guerra#n	true	guerras	feminine plural
Estonia#pn	false
Austria#pn	false
menos#r	true
radio#n	true	radios	masculine plural
Andorra#pn	false
Albania#pn	false
Armenia#pn	false
Bulgaria#pn	false
Cuba#pn	false
Honduras#pn	false
gas#n	false	gases	masculine plural
Liechtenstein#pn	false
Malta#pn	false
país#n	false	países	masculine plural
Portugal#pn	false
Vietnam#pn	false
amigo#n	true	amigos	masculine plural
amigo#a	true
amar#v	true
Australia#pn	false
Belarus#pn	false
Moldova#pn	false
radar#n	false	radares	masculine plural
Macedonia#pn	false
dar#v	true
banana#n	true	bananas	feminine plural
tigre#n	true	tigres	masculine plural
mental#a	true
diccionario#n	true	diccionarios	masculine plural
tuba#n	true	tubas	feminine plural
tempo#n	true	tempos	masculine plural
musical#a	true
some#v	true
animal#n	false	animais	masculine plural
animal#a	true
el#prn	true
for#v	true
koala#n	true	koalas	masculine plural
abandonar#v	true
abandono#v	true
case#r	true
irregular#a	true
kiwi#n	true	kiwis	masculine plural
estadounidense#n	true	estadounidenses	masculine plural
estadounidense#a	true
as#prn	true
adore#v	true
mundo#n	true	mundos	masculine plural
son#n	true	sons	masculine plural
son#v	true
non#r	true
iceberg#n	true	icebergs	masculine plural
habitual#a	true
chocolate#n	true	chocolates	feminine plural
tan#r	true
mosquito#n	true	mosquitos	masculine plural
carne#n	true	carnes	feminine plural
bosque#n	true	bosques	masculine plural
aceite#n	true	aceites	masculine plural
familia#n	true	familias	feminine plural
grupo#n	true	grupos	feminine plural
voz#n	false	voces	feminine plural
ben#n	true	bens	masculine plural
ben#r	true
ver#v	true
granada#n	true	granadas	feminine plural
plata#n	true	platas	feminine plural
burro#n	true	burros	masculine plural
me#prn	true
pato#n	true	patos	masculine plural
torta#n	true	tortas	feminine plural
saia#n	true	saias	feminine plural
saia#v	true
español#n	false	españois	masculine plural
español#a	true
español#pn	false
viña#n	true	viñas	feminine plural
viña#v	true
día#n	true	días	feminine plural
computadora#n	true	computadoras	feminine plural
luz#n	false	luces	feminine plural
mapa#n	true	mapas	masculine plural
rata#n	true	ratas	feminine plural
rato#n	true	ratos	masculine plural
nada#v	true
nada#prn	true
mama#v	true
vapor#n	false	vapores	feminine plural
come#v	true
tundra#n	true	tundras	feminine plural
lean#v	true
pula#v	true
mal#n	false	males	masculine plural
mal#r	true
legal#a	true
actor#n	false	actores	feminine plural
interior#n	false	interiores	masculine plural
interior#a	true
ideal#n	false	ideais	masculine plural
ideal#a	true
simple#a	true
cruel#a	true
proven#v	true
rode#v	true
era#v	true
limo#v	true
base#n	true	bases	feminine plural
altitude#n	true	altitudes	feminine plural
bacteria#n	true	bacterias	feminine plural
ven#v	true
ir#v	true
volume#n	true	volumes	masculine plural
pos#v	true
e#conj	true
horizontal#a	true
vertical#a	true
barón#n	true	baróns	masculine plural
Asia#pn	false
chan#n	true	chans	feminine plural
bo#a	true
ano#n	true	anos	masculine plural
celestial#a	true
home#n	true	homes	masculine plural
manga#n	true	mangas	feminine plural
ore#v	true
note#v	true
agora#r	true
han#v	true
artificial#a	true
garden#v	true
ha#v	true
corazón#n	true	corazóns	feminine plural
sangre#v	true
sei#v	true
eclipse#n	true	eclipses	feminine plural
flor#n	false	flores	feminine plural
música#n	true	músicas	feminine plural
libro#n	true	libros	feminine plural
cor#n	false	cores	feminine plural
beta#n	true	betas	masculine plural
gamma#n	true	gammas	feminine plural
contigo#r	true
delta#n	true	deltas	masculine plural
zeta#n	true	zetas	masculine plural
lunar#n	false	lunares	masculine plural
lunar#a	true
talo#n	true	talos	masculine plural
casa#n	true	casas	feminine plural
bicicleta#n	true	bicicletas	feminine plural
uva#n	true	uvas	feminine plural
tulipán#n	true	tulipáns	masculine plural
café#n	true	cafés	masculine plural
area#n	true	areas	feminine plural
neon#n	false	neon	masculine uncontable plural
argon#n	false	argon	masculine uncontable plural
xenon#n	false	xenon	masculine uncontable plural
fe#n	false	fe	feminine uncontable plural
radon#n	false	radon	masculine uncontable plural
emu#n	true	emus	masculine plural
na#prn	true
si#n	true	sis	masculine plural
si#prn	true
ar#n	false	ares	masculine plural
ti#prn	true
se#conj	true
se#prn	true
acción#n	true	accións	feminine plural
universal#a	true
escudo#n	true	escudos	masculine plural
la#n	true	las	masculine plural
la#prn	true
eu#prn	true
error#n	false	errores	feminine plural
ra#n	true	ras	feminine plural
es#v	true
democracia#n	true	democracias	feminine plural
pálpebra#n	true	pálpebras	feminine plural
der#v	true
individual#a	true
lava#n	true	lavas	feminine plural
vague#v	true
consume#v	true
mate#v	true
rectangular#a	true
negro#a	true
tomate#n	true	tomates	masculine plural
madeira#n	true	madeiras	feminine plural
Tarragona#pn	false
fan#v	true
pole#n	true	poles	feminine plural
pole#v	true
ampere#n	true	amperes	masculine plural
farad#n	true	farads	masculine plural
hertz#n	false	hertz	masculine uncontable plural
ohm#n	true	ohms	masculine plural
newton#n	true	newtons	masculine plural
volt#n	true	volts	masculine plural
watt#n	true	watts	masculine plural
forte#a	true
altar#n	false	altares	masculine plural
invisible#a	true
visible#a	true
estaba#v	true
estado#n	true	estados	masculine plural
estado#v	true
ido#v	true
ser#n	false	seres	masculine plural
ser#v	true
cobra#n	true	cobras	feminine plural
ordenador#n	true	ordenadors	masculine plural
té#n	true	tés	masculine plural
tea#n	true	teas	feminine plural
dis#v	true
España#pn	false
aquí#r	true
tsar#n	false	tsares	masculine plural
saber#v	true
pare#v	true
sumo#v	true
primavera#n	true	primaveras	feminine plural
secreto#a	true
curio#n	false	curio	masculine uncontable plural
rosa#n	true	rosas	feminine plural
italiano#n	true	italianos	masculine plural
italiano#a	true
italiano#pn	false
lumbar#a	true
mango#n	true	mangos	feminine plural
gabe#v	true
nebulosa#n	true	nebulosas	feminine plural
oasis#n	false	oases	feminine plural
porto#n	true	portos	masculine plural
porto#v	true
transporto#v	true
poeta#n	true	poetas	feminine plural
vulnero#v	true
vendo#v	true
Venus#pn	false
vir#v	true
vespa#n	true	vespas	feminine plural
lupa#n	true	lupas	feminine plural
alce#n	true	alces	masculine plural
leo#v	true
serra#n	true	serras	feminine plural
zona#n	true	zonas	feminine plural
corporal#n	false	corporais	masculine plural
corporal#a	true
inevitable#a	true
falar#v	true
beber#v	true
arma#n	true	armas	feminine plural
lagarto#n	true	lagartos	masculine plural
cabra#n	true	cabras	feminine plural
tubular#a	true
mexicano#n	true	mexicanos	masculine plural
mexicano#a	true
estudar#v	true
ela#prn	true
eles#prn	true
elas#prn	true
vós#prn	true
vos#prn	true
vulneras#v	true
nós#prn	true
nos#prn	true
verme#n	true	vermes	masculine plural
cantar#v	true
comprar#v	true
comer#v	true
correr#v	true
chegar#v	true
caber#v	true
diagonal#a	true
ler#v	true
hai#v	true
pero#conj	true
partir#v	true
pedir#v	true
querer#v	true
ter#v	true
vender#v	true
lago#n	true	lagos	masculine plural
dea#v	true
lingua#n	true	linguas	feminine plural
maior#a	true
alma#n	true	almas	feminine plural
africano#n	true	africanos	masculine plural
africano#a	true
actual#a	true
adaptable#a	true
pera#n	true	peras	feminine plural
calcio#n	false	calcio	masculine uncontable plural
escape#v	true
elefante#n	true	elefantes	masculine plural
marzo#n	true	marzos	masculine plural
biblioteca#n	true	bibliotecas	feminine plural
neve#n	true	neves	feminine plural
neve#v	true
sono#n	false	sono	masculine uncontable plural
ordinario#a	true
comparable#a	true
raro#a	true
remo#n	true	remos	masculine plural
ritmo#n	true	ritmos	masculine plural
Canadá#pn	false
lobo#n	true	lobos	masculine plural
superficial#a	true
amen#v	true
variable#n	true	variables	feminine plural
variable#a	true
vela#n	true	velas	feminine plural
araña#n	true	arañas	feminine plural
Rusia#pn	false
dan#v	true
fun#v	true
ante#n	true	antes	feminine plural
move#v	true
hotel#n	false	hoteis	masculine plural
di#v	true
bicara#v	true
saio#v	true
vento#n	true	ventos	masculine plural
vitamina#n	true	vitaminas	feminine plural
fígado#n	true	fígados	masculine plural
canguro#n	true	canguros	masculine plural
carta#n	true	cartas	feminine plural
coma#v	true
escritor#n	false	escritores	masculine plural
níquel#n	false	níquel	masculine uncontable plural
notable#a	true
fronte#n	true	frontes	feminine plural
madrileño#n	true	madrileños	masculine plural
madrileño#a	true
abella#n	true	abellas	feminine plural
whisky#n	true	whiskys	masculine plural
fame#n	true	fames	feminine plural
dedo#n	true	dedos	masculine plural
determine#v	true
polaco#n	true	polacos	masculine plural
polaco#a	true
polaco#pn	false
radical#n	false	radicais	masculine plural
zodíaco#n	true	zodíacos	masculine plural
zodíaco#pn	false
profeta#n	true	profetas	masculine plural
pace#v	true
padre#n	true	padres	feminine plural
che#prn	true
arco#n	true	arcos	feminine plural
lo#prn	true
Italia#pn	false
pulga#n	true	pulgas	feminine plural
faba#n	true	fabas	feminine plural
media#n	true	medias	feminine plural
fin#n	true	fins	feminine plural
mesa#n	true	mesas	feminine plural
segundo#n	true	segundos	masculine plural
gato#n	true	gatos	masculine plural
admirar#v	true
adorar#v	true
vez#n	false	veces	feminine plural
palabra#n	true	palabras	feminine plural
aeroplano#n	true	aeroplanos	masculine plural
alto#a	true
húngaro#n	true	húngaros	masculine plural
húngaro#a	true
húngaro#pn	false
catalán#n	true	cataláns	masculine plural
catalán#a	true
catalán#pn	false
dei#v	true
hoxe#r	true
ala#n	true	alas	feminine plural
vale#v	true
chaqueta#n	true	chaquetas	feminine plural
vulgar#a	true
placenta#n	true	placentas	feminine plural
albatros#n	false	albatros	masculine plural
terra#n	true	terras	feminine plural
diga#v	true
has#v	true
pirata#n	true	piratas	masculine plural
mono#n	true	monos	masculine plural
para#n	true	paras	feminine plural
din#v	true
virus#n	false	virus	masculine plural
les#v	true
porta#n	true	portas	feminine plural
porta#v	true
mel#n	false	meles	masculine plural
consigo#r	true
caixa#n	true	caixas	feminine plural
lido#v	true
aire#n	true	aires	masculine plural
pelo#n	true	pelos	masculine plural
le#v	true
ou#conj	true
clan#n	true	clans	masculine plural
mar#n	false	mares	masculine plural
pronto#a	true
pronto#r	true
hora#n	true	horas	feminine plural
transversal#n	false	transversais	feminine plural
transversal#a	true
tren#n	true	trens	masculine plural
quite#v	true
mes#n	false	meses	feminine plural
ser humano#n	false	seres humanos	masculine plural
ave#n	true	aves	feminine plural
golf#n	false	golf	masculine uncontable plural
levantar#v	true
mentir#v	true
nome#n	true	nomes	masculine plural
val#n	false	vales	masculine plural
mates#v	true
dobre#a	true
enigma#n	true	enigmas	feminine plural
medieval#a	true
triste#a	true
eran#v	true
sentir#v	true
latín#pn	false
pinta#v	true
primate#n	true	primates	masculine plural
lima#n	true	limas	feminine plural
lima#v	true
moi#r	true
tubo#n	true	tubos	masculine plural
pagan#v	true
cure#v	true
abandonado#v	true
porco#n	true	porcos	masculine plural
transpire#v	true
madre#n	true	madres	feminine plural
seco#v	true
temporal#n	false	temporais	masculine plural
temporal#a	true
mirar#v	true
pule#v	true
define#v	true
autor#n	false	autores	masculine plural
mosca#n	true	moscas	feminine plural
mandar#v	true
enviar#v	true
moa#n	true	moas	feminine plural
matar#v	true
material#n	false	materiais	masculine plural
col#n	false	coles	feminine plural
azul#a	true
probable#a	true
delgado#a	true
sangue#n	true	sangues	masculine plural
espada#n	true	espadas	feminine plural
prosa#n	false	prosa	feminine uncontable plural
quark#n	true	quarks	masculine plural
está#v	true
clima#n	true	climas	masculine plural
nasal#a	true
polo#n	true	polos	masculine plural
saltar#v	true
parar#v	true
pensar#v	true
principal#a	true
Hera#pn	false
leu#v	true
flexible#a	true
sino#n	true	sinos	masculine plural
dance#v	true
circular#a	true
perder#v	true
usual#a	true
odiar#v	true
algo#r	true
algo#prn	true
muito#a	true
muito#r	true
sinónimo#n	true	sinónimos	masculine plural
sinónimo#a	true
luxemburgués#n	false	luxemburgueses	masculine plural
luxemburgués#a	true
luxemburgués#pn	false
Biblia#pn	false
Europa#pn	false
limón#n	true	limóns	masculine plural
limar#v	true
satisfacer#v	true
amo#v	true
antimonio#n	false	antimonio	masculine uncontable plural
coreano#n	true	coreanos	masculine plural
coreano#a	true
coreano#pn	false
alga#n	true	algas	feminine plural
antes#n	false	antes		ante	singular
antes#r	true
aorta#n	true	aortas	feminine plural
canto#n	false	canto	masculine uncontable plural
canto#v	true
culler#n	false	culleres	feminine plural
dor#n	true	dors	feminine plural
facer#v	true
lea#v	true
magma#n	true	magmas	masculine plural
mica#n	false	mica	feminine uncontable plural
mire#v	true
nave#n	true	naves	feminine plural
tibia#n	false	m	feminine plural
tome#v	true
concede#v	true
dean#v	true
enlace#n	true	enlaces	masculine plural
fundamental#a	true
hale#v	true
mai#n	true	mais	feminine plural
ulna#n	true	ulnas	feminine plural
pretender#v	true
sistema operativo#n	false	sistemas operativos|head={{l|gl|sistema	masculine plural
mineral#n	false	minerais	masculine plural
frugal#a	true
iguana#n	true	iguanas	feminine plural
vietnamita#n	true	vietnamitas	masculine plural
vietnamita#a	true
vietnamita#pn	false
todo#a	true
supernova#n	true	supernovas	feminine plural
Hades#pn	false
Ares#pn	false
mato#v	true
provide#v	true
boliviano#n	true	bolivianos	masculine plural
boliviano#a	true
trigo#n	true	trigos	masculine plural
trigo#a	true
onda#n	true	ondas	feminine plural
Grecia#pn	false
ponte#n	true	pontes	feminine plural
sacro#n	true	sacros	masculine plural
sacro#a	true
leren#v	true
paz#n	false	paces	feminine plural
ferradura#n	true	ferraduras	feminine plural
ametista#n	true	ametistas	feminine plural
dente#n	true	dentes	masculine plural
inseparable#a	true
neutrino#n	true	neutrinos	masculine plural
posto#v	true
ide#v	true
diverso#a	true
inverno#n	true	invernos	masculine plural
antónimo#n	true	antónimos	masculine plural
antónimo#a	true
deus#n	false	deuses	masculine plural
reina#v	true
tromba#n	true	trombas	feminine plural
Francia#pn	false
entrar#v	true
tío#n	true	tíos	masculine plural
río#n	true	ríos	masculine plural
enciclopedia#n	true	enciclopedias	feminine plural
sueco#n	true	suecos	masculine plural
sueco#a	true
sueco#pn	false
comida#n	true	comidas	feminine plural
foder#v	true
salame#n	true	salames	masculine plural
social#a	true
agosto#n	true	agostos	masculine plural
iraquí#n	true	iraquís	masculine plural
iraquí#a	true
familiar#a	true
garda#v	true
ora#v	true
abreviatura#n	true	abreviaturas	feminine plural
frontal#n	false	frontais	feminine plural
frontal#a	true
cristal#n	false	cristais	masculine plural
telefono#v	true
só#n	true	sós	masculine plural
só#a	true
só#r	true
que#conj	true
que#prn	true
halo#v	true
actriz#n	false	actrices	feminine plural
illa#n	true	illas	feminine plural
orbital#a	true
molecular#a	true
vital#a	true
viro#v	true
dado#v	true
danza#v	true
vin#v	true
ferro#n	false	ferro	masculine uncontable plural
grande#a	true
volvo#v	true
banda#n	true	bandas	feminine plural
barca#n	true	barcas	feminine plural
saudade#n	false	saudades	feminine plural
rir#v	true
seren#v	true
trauma#n	true	traumas	masculine plural
ides#v	true
orca#n	true	orcas	feminine plural
bismuto#n	false	bismuto	masculine uncontable plural
sur#n	false	sures	masculine plural
Galiza#pn	false
brando#a	true
bruto#n	true	brutos	masculine plural
bruto#a	true
notes#v	true
bulbo#n	true	bulbos	masculine plural
viva#v	true
cervo#n	true	cervos	masculine plural
vulnerable#a	true
reine#v	true
luminoso#a	true
hawaiano#n	true	hawaianos	masculine plural
hawaiano#a	true
hawaiano#pn	false
incline#v	true
tropical#a	true
morte#n	true	mortes	feminine plural
meu#prn	true
árabe#n	true	árabes	masculine plural
árabe#a	true
árabe#pn	false
problema#n	true	problemas	masculine plural
min#prn	true
dito#v	true
horrible#a	true
visual#a	true
fume#v	true
provides#v	true
fondo#n	true	fondos	masculine plural
fonema#n	true	fonemas	masculine plural
sexa#v	true
haber#v	true
ocular#